###############
#             #
############# #
#             #
# #############
#             #
############# #
#             #
#             #
#             #
#             #
############# #
#             #
# #############
#             #
############# #
#             #
###############