###############
#      #      #
#  ##  #  ##  #
#      #      #
#      #      #
#      #      #
#  #   #   #  #
#      #      #
#             #
#             #
#      #      #
#  #   #   #  #
#      #      #
#      #      #
#      #      #
#  ##  #  ##  #
#      #      #
###############