###############
#     ###   ###
#     ###   ###
## ######   ###
##    ###   ###
##          ###
######## ######
###         ###
###         ###
###         ###
###         ###
####### #######
#             #
# ########### #
# #    #    # #
#      #      #
#      #      #
###############