###############
#             #
#             #
####### #######
######   ######
####       ####
###         ###
###         ###
###         ###
###         ###
###         ###
###         ###
####       ####
######   ######
####### #######
#             #
#             #
###############