###############
####### #######
######   ######
#####     #####
####       ####
#####     #####
#####     #####
######   ######
####### #######
####### #######
######   ######
#####     #####
####       ####
#####     #####
#####     #####
######   ######
####### #######
###############