###############
#             #
#   #####     #
#             #
#             #
#             #
#             #
#             #
#      ##     #
#      ##     #
#             #
#             #
#             #
#             #
#             #
#     #####   #
#             #
###############