###############
#             #
#   ########  #
#  #         ##
#   ########  #
#             #
#  ####  ##   #
#      #   #  #
#  #########  #
#             #
#  #       #  #
#  #   #   #  #
#  #########  #
#             #
#  #########  #
#      #      #
#  #########  #
#             #